00000000000000
00000000000000
00000111000000
00000000000000
00110000000000
00000000111110
00000000000000
00111111111000